########################################
#                                      #
#                                      #
#                                      #
#                                      #
#                                      #
#                                      #
#                                      #
#                                      #
#                 G                    #
#                                      #
#                                      #
#                                      #
#                                      #
#                                      #
#                 e                    #
#                                      #
#                                      #
#                                      #
#                 P                    #
#                                      #
#                                      #
#                                      #
#            ...........               #
#                                      #
#                                      #
#                                      #
#                                      #
#                                      #
#                                      #
########################################
